{
  "name": "Bridge",
  "width": 15,
  "height": 15,
  "heights": [
    [1, 1, 1, 1, 1, 1, 0, 0, 0, 1, 1, 1, 1, 1, 1],
    [1, 1, 1, 1, 1, 1, 0, 0, 0, 1, 1, 1, 1, 1, 1],
    [1, 1, 1, 1, 1, 1, 0, 0, 0, 1, 1, 1, 1, 1, 1],
    [1, 1, 1, 1, 1, 1, 0, 0, 0, 1, 1, 1, 1, 1, 1],
    [1, 1, 1, 1, 1, 1, 0, 0, 0, 1, 1, 1, 1, 1, 1],
    [1, 1, 2, 2, 1, 1, 0, 0, 0, 1, 1, 2, 2, 1, 1],
    [1, 1, 2, 2, 1, 1, 1, 1, 1, 1, 1, 2, 2, 1, 1],
    [1, 1, 2, 2, 1, 1, 1, 1, 1, 1, 1, 2, 2, 1, 1],
    [1, 1, 2, 2, 1, 1, 1, 1, 1, 1, 1, 2, 2, 1, 1],
    [1, 1, 2, 2, 1, 1, 0, 0, 0, 1, 1, 2, 2, 1, 1],
    [1, 1, 1, 1, 1, 1, 0, 0, 0, 1, 1, 1, 1, 1, 1],
    [1, 1, 1, 1, 1, 1, 0, 0, 0, 1, 1, 1, 1, 1, 1],
    [1, 1, 1, 1, 1, 1, 0, 0, 0, 1, 1, 1, 1, 1, 1],
    [1, 1, 1, 1, 1, 1, 0, 0, 0, 1, 1, 1, 1, 1, 1],
    [1, 1, 1, 1, 1, 1, 0, 0, 0, 1, 1, 1, 1, 1, 1]
  ],
  "spawns": {
    "player": [[0, 6], [0, 7], [0, 8], [1, 6], [1, 8]],
    "enemy":  [[14, 6], [14, 7], [14, 8], [13, 6], [13, 8]]
  }
}
