{
  "name": "High Ground",
  "width": 15,
  "height": 15,
  "heights": [
    [1, 1, 1, 1, 1, 1, 1, 1, 1, 1, 1, 1, 1, 1, 1],
    [1, 1, 1, 1, 1, 1, 1, 1, 1, 1, 1, 1, 1, 1, 1],
    [1, 1, 1, 1, 1, 1, 2, 2, 2, 1, 1, 1, 1, 1, 1],
    [1, 1, 1, 1, 1, 2, 3, 3, 3, 2, 1, 1, 1, 1, 1],
    [1, 1, 1, 1, 2, 3, 4, 4, 4, 3, 2, 1, 1, 1, 1],
    [1, 1, 1, 1, 2, 3, 4, 5, 4, 3, 2, 1, 1, 1, 1],
    [1, 1, 1, 1, 2, 3, 4, 5, 4, 3, 2, 1, 1, 1, 1],
    [1, 1, 1, 1, 2, 3, 4, 4, 4, 3, 2, 1, 1, 1, 1],
    [1, 1, 1, 1, 2, 3, 4, 4, 4, 3, 2, 1, 1, 1, 1],
    [1, 1, 1, 1, 2, 3, 4, 4, 4, 3, 2, 1, 1, 1, 1],
    [1, 1, 1, 1, 1, 2, 3, 3, 3, 2, 1, 1, 1, 1, 1],
    [1, 1, 1, 1, 1, 1, 2, 2, 2, 1, 1, 1, 1, 1, 1],
    [1, 1, 1, 1, 1, 1, 1, 1, 1, 1, 1, 1, 1, 1, 1],
    [1, 1, 1, 1, 1, 1, 1, 1, 1, 1, 1, 1, 1, 1, 1],
    [1, 1, 1, 1, 1, 1, 1, 1, 1, 1, 1, 1, 1, 1, 1]
  ],
  "spawns": {
    "player": [[0, 7], [1, 6], [1, 7], [1, 8], [2, 7]],
    "enemy":  [[14, 7], [13, 6], [13, 7], [13, 8], [12, 7]]
  }
}
